title,date,likes,comments,views,duration,sponsor,cumulative_views,ID
1. Grupa Wyszehradzka,2017-03-04,1182,62,30484,532.0,No sponsor,30484,1
2. Kto zostanie prezydentem Francji?,2017-03-18,149,10,4366,754.0,No sponsor,34850,2
3. Korea Północna - Historia i teraźniejszość,2017-04-18,448,26,11864,859.0,No sponsor,46714,3
4. Recep Tayyip Erdoğan - nowy sułtan Turcji,2017-04-24,651,28,14138,745.0,No sponsor,60852,4
5. Emmanuel Macron - nowy prezydent Francji,2017-05-08,364,17,9835,781.0,No sponsor,70687,5
6. Świat na skraju wojny handlowej,2018-04-08,478,19,12615,512.0,No sponsor,83302,6
"7. Tydzień na świecie #1 - Atak na Syrię, Nord Stream 2 i chińskie ćwiczenia wojskowe",2018-04-16,132,12,2636,392.0,No sponsor,85938,7
8. O co chodzi w wojnie w Syrii?,2018-04-19,1997,127,47837,601.0,No sponsor,133775,8
"9. Tydzień na świecie #2 - Trump spotka się z Kimem, Baltic Pipe i nowy prezydent na Kubie",2018-04-23,65,4,1290,235.0,No sponsor,135065,9
10. Polska konstytucja a polityka zagraniczna,2018-04-26,388,8,6131,405.0,No sponsor,141196,10
11. Ustawa 447 i groźba roszczeń organizacji żydowskich z USA,2018-05-02,238,18,4749,542.0,No sponsor,145945,11
12. Czy Węgry to naturalny sojusznik Polski?,2018-05-18,1849,130,49401,530.0,No sponsor,195346,12
13. Czy Unia Europejska przetrwa bez Stanów Zjednoczonych?,2018-08-07,958,70,25612,541.0,No sponsor,220958,13
14. Iran vs USA - źródła nienawiści,2018-08-14,1603,116,26442,638.0,No sponsor,247400,14
15. Dokąd zmierza Wielka Brytania?,2018-09-14,1159,149,31029,591.0,No sponsor,278429,15
16. Trójmorze - czy to się może udać?,2018-09-21,4051,445,143103,649.0,No sponsor,421532,16
17. Czy czeka nas kolejna zimna wojna?,2018-10-12,726,63,9061,422.0,No sponsor,430593,17
18. Nord Stream 2 And The Future Of Europe,2018-12-09,308,57,4019,403.0,No sponsor,434612,18
19. Rola Polski w nowym globalnym konflikcie,2019-01-19,866,72,15128,648.0,No sponsor,449740,19
20. Amerykańskie bombardowania Oświęcimia,2019-02-13,355,31,6145,1583.0,No sponsor,455885,20
21. Na kogo głosować w wyborach do Parlamentu Europejskiego?,2019-05-18,650,160,16210,1310.0,No sponsor,472095,21
22. Dlaczego Amerykanie okażą nam wsparcie właśnie TERAZ?,2019-06-11,503,61,6305,392.0,No sponsor,478400,22
23. Hongkong - pierwsze starcie w nowej zimnej wojnie?,2019-08-16,580,36,6752,605.0,No sponsor,485152,23
24. Rosja i jej zaklęty krąg,2019-08-23,928,84,13233,447.0,No sponsor,498385,24
25. II wojna światowa a niemiecka ekspansja na wschód,2019-09-06,488,41,5868,580.0,No sponsor,504253,25
26. Czy Amerykanie zdradzili Polskę?,2019-09-13,693,82,9183,574.0,No sponsor,513436,26
27. Q&A# 1 - Nie jestem samozwańczym mędrcem!,2019-09-25,823,58,10563,1517.0,No sponsor,523999,27
28. Francja największym zagrożeniem dla przyszłości Europy?,2019-10-24,3308,237,87555,647.0,No sponsor,611554,28
29. Rosyjska porażka w historycznym sporze,2020-02-11,2417,283,62018,865.0,No sponsor,673572,29
"30. Koronawirus, negocjacje między Białorusią i Rosją oraz prawybory w USA - Tydzień na Świecie 5-12.02",2020-02-13,476,28,5958,521.0,No sponsor,679530,30
31. Czy Ukraińcom uda się zbudować sprawne państwo?,2020-02-18,3183,1045,76735,777.0,No sponsor,756265,31
32. Miliard dolarów dla Trójmorza i strategiczne wizje Emmanuela Macrona - Tydzień na Świecie 13-19.02,2020-02-20,634,45,7879,503.0,No sponsor,764144,32
33. Wołodymyr Zełeński - kim jest prezydent Ukrainy?,2020-02-25,2970,425,107148,816.0,No sponsor,871292,33
"34. Trump w Indiach, zamach w Niemczech i rozwój epidemii koronawirusa -   Tydzień na Świecie 20-26.02",2020-02-27,479,25,4047,469.0,No sponsor,875339,34
35. Zachód zakładnikiem Turcji,2020-03-03,815,59,10322,677.0,No sponsor,885661,35
"36. Nowy kryzys migracyjny, zmiana premiera na Ukrainie i wielki powrót Bidena - Tydzień na Świecie#4",2020-03-05,470,23,5011,564.0,No sponsor,890672,36
37. Czy Polska dostarczy ropę na Białoruś,2020-03-11,1026,94,17937,683.0,No sponsor,908609,37
38. Władimir Putin wiecznym prezydentem i olbrzymie spadki cen ropy naftowej - Tydzień na Świecie#5,2020-03-12,581,14,7185,579.0,No sponsor,915794,38
39. Największy dylemat polskiej polityki zagranicznej,2020-03-17,2709,360,36160,893.0,No sponsor,951954,39
40. Nowy sojusznik Polski i kontrowersyjna decyzja prezydenta Zełeńskiego - Tydzień na Świecie#6,2020-03-19,1171,71,25276,473.0,No sponsor,977230,40
41. Jak wirus obnażył słabości Europy,2020-03-24,12450,1289,386055,1086.0,No sponsor,1363285,41
"42. Polsko-białoruskie ćwiczenia wojskowe, plaga szarańczy i wizja wojny o wodę - Tydzień na Świecie#7",2020-03-26,1351,94,19202,475.0,No sponsor,1382487,42
43. Jak naprawić Unię Europejską?,2020-03-31,1678,201,25305,1008.0,No sponsor,1407792,43
"44. Rosjanie zapłacą 6 miliardów polskiej spółce,  ratowanie gospodarek w UE i USA -Tydzień na Świecie#8",2020-04-02,1286,89,18752,495.0,No sponsor,1426544,44
45. Jan Paweł II a niepodległość Polski,2020-04-07,1016,123,14098,1151.0,No sponsor,1440642,45
46. Jak skorzystać na kryzysie?,2020-04-14,1686,144,27781,998.0,No sponsor,1468423,46
"47. Pożar w Czarnobylu, USA przestają finansować WHO i porozumienie naftowe - Tydzień na Świecie#9",2020-04-16,1148,81,14100,477.0,No sponsor,1482523,47
48. Wybory w czasie epidemii,2020-04-21,1172,118,13428,1110.0,No sponsor,1495951,48
"49. Polsko-białoruskie porozumienie,  Trump grozi Iranowi i spór w ramach UE - Tydzień na Świecie#10",2020-04-23,1846,123,18704,566.0,No sponsor,1514655,49
50. Jak wywrócić geopolityczne równanie do góry nogami?,2020-04-28,1345,89,17989,1035.0,No sponsor,1532644,50
51. Największy kryzys w najnowszej historii Europy i kłopoty Joe Bidena - Tydzień na świecie #11,2020-04-30,1046,55,12151,520.0,No sponsor,1544795,51
52. Jaką politykę zagraniczną prowadził prezydent Andrzej Duda?,2020-05-05,1872,239,33404,1108.0,No sponsor,1578199,52
53. Niemiecki spór o broń atomową i wzmożone kontakty Polski z Białorusią - Tydzień na świecie #11,2020-05-07,1397,138,15060,605.0,No sponsor,1593259,53
54. Pozycja Polski w Unii Europejskiej,2020-05-12,2247,229,36700,811.0,No sponsor,1629959,54
"55. Nowa strategia bezpieczeństwa Polski, niemiecki trybunał wbrew wyrokowi TSUE - Tydzień na Świecie#13",2020-05-14,1120,121,12419,625.0,No sponsor,1642378,55
56. Czy NATO przetrwa?,2020-05-19,1643,192,25137,883.0,No sponsor,1667515,56
57. Nowa strategia USA wobec Chin oraz możliwy przełom w Unii Europejskiej - Tydzień na Świecie #14,2020-05-21,1372,72,14970,577.0,No sponsor,1682485,57
58. Tak decydują się losy Europy,2020-05-26,1822,243,21973,790.0,No sponsor,1704458,58
59. Propozycja budżetu Komisji Europejskiej,2020-05-27,981,83,8914,161.0,No sponsor,1713372,59
60. Ważna deklaracja Angeli Merkel i koniec niezależności Hong Kongu - Tydzień na Świecie #15,2020-05-28,1679,140,19069,621.0,No sponsor,1732441,60
61. Dlaczego Ameryka płonie?,2020-06-02,2870,470,50052,979.0,No sponsor,1782493,61
62. Możliwy przełom na Białorusi i dalszy ciąg burd na amerykańskich ulicach - Tydzień na Świecie #16,2020-06-04,1484,95,16532,578.0,No sponsor,1799025,62
63. USA kontra Niemcy,2020-06-09,2209,194,40424,834.0,No sponsor,1839449,63
64. Koniec epoki globalnego policjanta,2020-06-16,2733,241,39050,759.0,No sponsor,1878499,64
65. Andrzej Duda zaproszony do Waszyngtonu i starcia na granicy indyjsko-chińskiej,2020-06-18,1623,104,18716,624.0,No sponsor,1897215,65
66. Wybory prezydenckie a polityka zagraniczna,2020-06-23,1477,154,17202,920.0,No sponsor,1914417,66
67. Wizyta prezydenta Polski w Stanach Zjednoczonych i coraz bardziej napięta sytuacja na Białorusi,2020-06-25,1277,62,14597,548.0,No sponsor,1929014,67
68. Niemiecka Unia Europejska,2020-06-30,2156,289,31505,837.0,No sponsor,1960519,68
69. Najważniejszy film w moim życiu,2020-07-06,3400,250,23505,469.0,No sponsor,1984024,69
70. Rosja najsłabsza od stuleci,2020-07-07,6111,728,151138,895.0,No sponsor,2135162,70
71. Nowe plany obronne Polski i coraz trudniejsza sytuacja Donalda Trumpa - Tydzień na świecie,2020-07-09,1888,166,22515,607.0,No sponsor,2157677,71
72. Praworządność - czy Polska straci miliardy?,2020-07-14,1556,222,18091,859.0,No sponsor,2175768,72
73. Setki zatrzymań na Białorusi i starcia zbrojne między Armenią i Azerbejdżanem - Tydzień na Świecie,2020-07-16,1830,161,18811,619.0,No sponsor,2194579,73
"74. Jakub Wiech o Nord Stream 2, Nowym Zielonym Ładzie i transformacji energetycznej Polski",2020-07-21,1506,219,23510,1845.0,No sponsor,2218089,74
75. Porozumienie wszystkich państw UE i ostre spięcia na linii USA-Chiny - Tydzień na Świecie,2020-07-23,1440,117,15927,591.0,No sponsor,2234016,75
76. USA vs Chiny - czy tu rozpocznie się konflikt?,2020-07-28,1967,248,31673,726.0,No sponsor,2265689,76
77. Polska zacieśnia współpracę z Ukrainą i Litwą i zatrzymanie Rosjan na Białorusi - Tydzień na świecie,2020-07-30,1661,109,20222,601.0,No sponsor,2285911,77
78. Włoska katastrofa finansowa,2020-08-04,3279,481,67185,937.0,No sponsor,2353096,78
79. Holenderska hipokryzja,2020-08-11,3477,346,77791,780.0,No sponsor,2430887,79
80. Co dalej z Białorusią?,2020-08-18,3674,580,66143,1121.0,No sponsor,2497030,80
81. Unijny szczyt ws. Białorusi i dymisja ministra spraw zagranicznych - Tydzień na Świecie,2020-08-20,1830,125,19568,644.0,No sponsor,2516598,81
82. Polska wobec Białorusi,2020-08-26,2652,472,43173,1141.0,No sponsor,2559771,82
83. Rządzący i opozycja wspólnym głosem na temat Białorusi i kolejna fala protestów w USA,2020-08-27,1518,193,17583,587.0,No sponsor,2577354,83
84. Niemiecki (nie)porządek,2020-09-01,2678,294,35658,908.0,No sponsor,2613012,84
85. Rosja vs Zachód - czy Nord Stream 2 powstanie?,2020-09-08,2085,311,27309,928.0,No sponsor,2640321,85
"86. Aresztowania na Białorusi, protesty w Bułgarii i rezygnacja Shinzo Abe",2020-09-10,1542,85,16703,584.0,No sponsor,2657024,86
87. Brytyjski chaos,2020-09-15,2360,183,31789,1090.0,No sponsor,2688813,87
88. Historyczne osiągnięcie Donalda Trumpa i ważne przemówienie Ursuli von der Leyen,2020-09-17,1651,84,20618,714.0,No sponsor,2709431,88
89. Jak Donald Trump na trwałe zmieni Stany Zjednoczone,2020-09-22,2523,151,33683,920.0,No sponsor,2743114,89
90. Potajemna inauguracja kolejnej kadencji Łukaszenki oraz Zgromadzenie Ogólne ONZ - Tydzień na Świecie,2020-09-24,1334,67,16260,668.0,No sponsor,2759374,90
91. Armenia vs Azerbejdżan - Wojna na Kaukazie,2020-09-30,3801,613,95303,974.0,No sponsor,2854677,91
"92. Donald Trump z koronawirusem, wojna na Kaukazie i szczyt Rady Europejskiej - Tydzień na Świecie",2020-10-02,1988,104,17718,561.0,No sponsor,2872395,92
93. Żyjemy w najbardziej niesamowitym czasie w historii ludzkości,2020-10-20,2478,208,30090,1023.0,No sponsor,2902485,93
94. Szczyt Trójmorza i ostatnia prosta przed amerykańskimi wyborami,2020-10-23,1443,58,13995,576.0,No sponsor,2916480,94
95. Trump vs Biden - kto zostanie prezydentem?,2020-10-28,1813,196,26986,1198.0,No sponsor,2943466,95
"96. Druga fala koronawirusa zalewa Europę, wybory w USA i dalszy ciąg walki Białorusinów",2020-10-30,1551,119,13839,579.0,No sponsor,2957305,96
97. Live Q&A,2020-11-02,699,37,10046,3881.0,No sponsor,2967351,97
98. Co musisz wiedzieć o wyborach w USA?,2020-11-06,1569,212,17025,739.0,No sponsor,2984376,98
99. Źródła dezinformacji,2020-11-10,1539,148,16569,766.0,No sponsor,3000945,99
"100. Klęska Armenii, zwycięstwo Azerbejdżanu - wojna na Kaukazie",2020-11-13,2381,250,50622,606.0,No sponsor,3051567,100
101. Wielki błąd Unii Europejskiej,2020-11-17,3754,548,49788,1114.0,No sponsor,3101355,101
102. Największa umowa handlowa świata - Podsumowanie wydarzeń,2020-11-20,1721,120,21090,553.0,No sponsor,3122445,102
103. Czym jest Unia Europejska?,2020-11-25,2424,390,32288,946.0,No sponsor,3154733,103
104. Jak naprawić wizerunek Polski?,2020-12-02,2754,328,31027,789.0,No sponsor,3185760,104
105. Napięte stosunki w Europie i protesty we Francji,2020-12-04,2010,175,24033,621.0,No sponsor,3209793,105
106. Australia - na froncie walki światów,2020-12-10,1997,91,25411,691.0,No sponsor,3235204,106
107. Bilans batalii o praworządność,2020-12-15,1653,124,22141,1019.0,No sponsor,3257345,107
108. Joe Biden oficjalnie kolejnym prezydentem USA i zatwierdzony budżet Unii Europejskiej,2020-12-18,1168,78,14474,626.0,No sponsor,3271819,108
109. Polityka Zagraniczna 2020 - podsumowanie,2020-12-23,1924,129,15914,636.0,No sponsor,3287733,109
110. Porozumienie handlowe Unia Europejska - Chiny,2021-01-05,2103,255,26574,1092.0,No sponsor,3314307,110
111. Upadek,2021-01-07,3635,605,50957,1059.0,No sponsor,3365264,111
112. Rosyjskie służby specjalne,2021-01-14,2263,178,36717,704.0,No sponsor,3401981,112
113. Jak rozkradana jest Ukraina,2021-01-19,4331,861,109879,810.0,No sponsor,3511860,113
114. Zapraszam na nowy kanał!,2021-01-22,1424,122,13876,99.0,No sponsor,3525736,114
115. Polityka zagraniczna prezydenta Donalda Trumpa,2021-01-26,1964,164,25967,1025.0,No sponsor,3551703,115
116. Skrót wydarzeń ze świata,2021-01-29,1590,70,16237,303.0,No sponsor,3567940,116
"117. Szczepionki - brutalna polityka, brutalny biznes",2021-02-05,1649,132,17608,986.0,No sponsor,3585548,117
118. Jak Rosja upokorzyła Unię Europejską,2021-02-10,3062,418,45430,845.0,No sponsor,3630978,118
119. Skrót wydarzeń ze świata,2021-02-12,1329,81,15769,328.0,No sponsor,3646747,119
120. Francuska wizja przyszłości Europy,2021-02-16,2687,376,42972,791.0,No sponsor,3689719,120
121. Skrót wydarzeń ze świata,2021-02-19,1661,72,17520,548.0,No sponsor,3707239,121
122. Indie - tajemnicza potęga,2021-02-23,2990,186,50959,879.0,No sponsor,3758198,122
123. Polska i Ukraina wspólnym głosem na temat Nord Stream 2 i konflikt Australii z Facebookiem,2021-02-26,1315,96,15657,599.0,No sponsor,3773855,123
124. Europejczyk,2021-03-01,3007,230,26066,214.0,No sponsor,3799921,124
125. Unijne problemy ze szczepionkami,2021-03-05,1085,38,13282,575.0,No sponsor,3813203,125
126. Zrozumieć Niemcy,2021-03-09,3039,329,46300,895.0,No sponsor,3859503,126
127. Wielki pakiet socjalny w USA i Niemcy przeciwko energii z atomu w UE,2021-03-12,2707,470,26367,616.0,No sponsor,3885870,127
128. Technologiczne zacofanie Unii Europejskiej,2021-03-17,3239,300,43478,1029.0,No sponsor,3929348,128
129. Prezydent USA nazywa Putina mordercą i szczyt Chiny - USA - Tydzień na Świecie,2021-03-19,2154,210,29709,634.0,No sponsor,3959057,129
130. Polska polityka wschodnia - powrót do korzeni,2021-03-24,2958,330,32575,886.0,No sponsor,3991632,130
"131. Zatrzymania Polaków na Białorusi, amerykańska ofensywa dyplomatyczna w Europie i wybory w Izraelu",2021-03-26,1745,155,21492,606.0,No sponsor,4013124,131
132. Na początku był CHAOS - czyli przepis na europejską integrację,2021-03-30,1716,248,22301,788.0,No sponsor,4035425,132
133. Europejska bezradność Prawa i Sprawiedliwości,2021-04-06,2542,385,37002,936.0,No sponsor,4072427,133
134. Czy Rosja zaatakuje Ukrainę?,2021-04-09,5338,1364,165710,847.0,No sponsor,4238137,134
135. Rola państw w Unii Europejskiej,2021-04-14,1848,288,27731,581.0,No sponsor,4265868,135
136. Ukraiński kryzys i słabość Polski,2021-04-21,3494,586,53369,881.0,No sponsor,4319237,136
"137. Rosjanie wycofują wojska,  Czesi stawiają się Moskwie a Amerykanie organizują szczyt klimatyczny",2021-04-23,3175,374,72794,589.0,No sponsor,4392031,137
138. Niemcy - wielkie zmiany na horyzoncie,2021-04-28,2847,338,45457,842.0,No sponsor,4437488,138
139. Dalszy ciąg napięć na linii Rosja - Ukraina i wystąpienie Joe Bidena w Kongresie,2021-04-30,1841,78,21226,585.0,No sponsor,4458714,139
140. Fundusz odbudowy - utrata suwerenności czy nowy plan Marshalla?,2021-05-06,3072,352,37085,1103.0,No sponsor,4495799,140
141. Europa Środkowo-Wschodnia - rosnące ambicje,2021-05-12,2916,264,43037,908.0,No sponsor,4538836,141
"142. Atak hakerski na USA, niepokój społeczny we Francji i patent na szczepionki",2021-05-14,2075,102,20527,624.0,No sponsor,4559363,142
143. Przyczyny konfliktu izraelsko-palestyńskiego,2021-05-19,5648,470,173368,896.0,No sponsor,4732731,143
144. Białoruś - w stronę państwa policyjnego,2021-05-27,2751,478,31088,868.0,No sponsor,4763819,144
145. Amerykanie wolą Niemców. I co teraz?,2021-06-01,3208,726,45964,844.0,No sponsor,4809783,145
146. Tragedia białoruskiego dziennikarza i trudne chwile dla polskiego bezpieczeństwa energetycznego,2021-06-04,1915,157,26595,648.0,No sponsor,4836378,146
147. Jak w miarę tanio zwiedzać świat,2021-06-08,1622,102,19096,924.0,No sponsor,4855474,147
148. Polska vs Czechy - spór o kopalnię w Turowie,2021-06-11,3071,716,57201,857.0,No sponsor,4912675,148
"149. Prezydent USA w Europie. Nowy styl, ten sam cel - Chiny",2021-06-17,1906,162,24598,853.0,No sponsor,4937273,149
150. Czy Rosjanie zaatakowali Polskę w cyberprzestrzeni?,2021-06-23,1834,136,20900,763.0,No sponsor,4958173,150
151. Co wydarzyło się na świecie? Podsumowanie wydarzeń,2021-06-25,2130,120,24184,628.0,No sponsor,4982357,151
152. Czy Stany Zjednoczone potrzebują Polski?,2021-06-30,2875,407,54878,683.0,No sponsor,5037235,152
"153. Chiny prężą muskuły, Zełeński kpi z Putina, a w Kanadzie płoną kościoły",2021-07-02,2506,218,36797,628.0,No sponsor,5074032,153
"154. Trójmorze - koniec złudzeń, czy nowy początek?",2021-07-08,3463,832,80771,844.0,No sponsor,5154803,154
155. Ukraińska tożsamość a Trójkąt Lubelski,2021-07-13,4274,1423,111404,738.0,No sponsor,5266207,155
156. Angela Merkel w USA i reformy klimatyczne w UE,2021-07-16,1736,134,23589,598.0,No sponsor,5289796,156
157. Kto zapłaci za ocieplenie klimatu?,2021-07-21,2371,702,30380,812.0,No sponsor,5320176,157
"158. Nord Stream 2 - potęga Niemiec, bezsilność UE",2021-07-28,2634,412,41607,736.0,No sponsor,5361783,158
"159. Ustawa antyTVN, przewrót w Tunezji i Talibowie w Chinach",2021-07-30,2700,246,34751,606.0,No sponsor,5396534,159
160. KOSOWO - pogranicze cywilizacji,2021-08-04,3213,234,52414,859.0,No sponsor,5448948,160
161. Migracja – narzędzie agresji i przyszłość Europy,2021-08-11,3027,311,46647,693.0,No sponsor,5495595,161
"162. Ustawa medialna, ofensywa talibów i raport dotyczący ocieplenia klimatu",2021-08-13,2683,270,39995,647.0,No sponsor,5535590,162
163. Upadek Afganistanu,2021-08-18,5407,708,160679,890.0,No sponsor,5696269,163
"164. Kryzys w relacjach z Izraelem, Afganistan i wybory w Kanadzie",2021-08-20,2066,171,41633,516.0,No sponsor,5737902,164
165. Białoruś – bandycki reżim Aleksandra Łukaszenki,2021-08-25,3730,386,48264,571.0,No sponsor,5786166,165
"166. Dyplomatyczna ofensywa Ukrainy, wybory w Niemczech i ciąg dalszy granicznego kryzysu",2021-09-03,2819,146,39735,605.0,No sponsor,5825901,166
167. Koniec epoki w polityce zagranicznej USA,2021-09-08,2430,254,26489,811.0,No sponsor,5852390,167
"168. Integracja Rosji i Białorusi, spór z Unią Europejską i konferencja w Karpaczu",2021-09-10,2752,134,32475,620.0,No sponsor,5884865,168
169. W jakim stanie jest Unia Europejska? Wrażenia po spotkaniu z Ursulą von der Leyen,2021-09-17,3206,311,30828,816.0,No sponsor,5915693,169
"170. Jak Amerykanie oszukali Europę, czyli konsekwencje polityki UE wobec Chin",2021-09-22,4580,449,86252,825.0,No sponsor,6001945,170
171. Kary za kopalnię w Turowie i spotkanie szefów MSZ Polski i Rosji,2021-09-24,2347,200,34200,630.0,No sponsor,6036145,171
172. Kto wygrał wybory w Niemczech?,2021-09-29,3320,249,46832,805.0,No sponsor,6082977,172
173. Zerwane negocjacje z Czechami i dalszy ciąg kryzysu na granicy,2021-10-01,2376,190,36051,601.0,No sponsor,6119028,173
174. Jak Francja dyskryminuje polskie firmy,2021-10-06,2905,264,45225,776.0,No sponsor,6164253,174
"175. Konflikt Polski z UE, szczyt ws. Bałkanów Zachodnich i Warsaw Security Forum",2021-10-08,2200,274,30348,601.0,No sponsor,6194601,175
176. Czy sędziowie w Polsce są niezależni?,2021-10-12,2354,450,30262,815.0,No sponsor,6224863,176
"177. Przyszłość energii atomowej w UE, migracja do Polski i praworządność cd.",2021-10-15,2087,103,29154,678.0,No sponsor,6254017,177
178. Dlaczego Niemcy uzależniają się od Rosji?,2021-10-21,3336,470,67191,776.0,No sponsor,6321208,178
179. Polska katastrofa demograficzna,2021-10-27,4334,1184,64247,859.0,No sponsor,6385455,179
"180. Wizyta prezydenta we Francji, Rosja szantażuje Mołdawię i PL vs EU cd.",2021-10-29,2481,210,36820,625.0,No sponsor,6422275,180
181. Polska w średniowieczu też nie była praworządna!,2021-11-03,2627,170,29790,856.0,No sponsor,6452065,181
182. Zrównoważony świat globalnych elit,2021-11-05,2122,147,30675,514.0,No sponsor,6482740,182
183. Dlaczego Białoruś atakuje Polskę?,2021-11-12,13654,1051,514253,789.0,No sponsor,6996993,183
184. Arabia Saudyjska – ropa i krew,2021-11-16,3091,202,40933,845.0,No sponsor,7037926,184
185. LIVE Q&A - Polityka Zagraniczna,2021-11-23,1298,55,20934,4031.0,No sponsor,7058860,185
186. Ukraińska wojna o niepodległość?,2021-12-02,4908,543,96344,1107.0,No sponsor,7155204,186
187. Rozgrywka o status Europy Środkowo-Wschodniej,2021-12-10,4972,615,117155,837.0,No sponsor,7272359,187
188. Niemcy – umowa koalicyjna i wizyta kanclerza w Warszawie,2021-12-15,2634,251,41373,864.0,No sponsor,7313732,188
"189. Konflikt Chin i Litwy, spotkanie Putina z Xi i szczyt UE",2021-12-17,3337,147,68138,682.0,No sponsor,7381870,189
190. Absurdalne żądania Rosji wobec NATO,2021-12-23,8982,753,205248,778.0,No sponsor,7587118,190
191. Czy Polska przegrywa z pandemią?,2022-01-05,3477,803,44878,724.0,No sponsor,7631996,191
"192. Kazachstan – historia, zamieszki i rosnące wpływy Rosji",2022-01-12,3822,205,61355,1053.0,No sponsor,7693351,192
193. Kupmy sobie premiera Francji,2022-01-14,4220,235,41139,145.0,No sponsor,7734490,193
194. Widmo wojny – część 1,2022-01-19,5101,784,96309,748.0,No sponsor,7830799,194
195. Widmo wojny – część 2. Katastrofalny błąd Bidena,2022-01-21,7239,849,126296,815.0,No sponsor,7957095,195
196. Koniec rządów Borisa Johnsona?,2022-01-26,3008,242,46240,786.0,No sponsor,8003335,196
197. Widmo wojny – część 3. Spokój Ukrainy,2022-01-28,5459,513,99050,872.0,No sponsor,8102385,197
198. Władimir Putin – jak upada rosyjski projekt imperialny,2022-02-03,14846,1535,404115,1046.0,No sponsor,8506500,198
199. Jak Unia Europejska rządzi światem,2022-02-10,5311,430,84810,936.0,No sponsor,8591310,199
200. Rosja vs Ukraina – (nie)porozumienia mińskie,2022-02-16,4938,400,89649,697.0,No sponsor,8680959,200
201. Rosja atakuje Ukrainę,2022-02-24,11955,905,191149,677.0,No sponsor,8872108,201
202. Zachód wobec rosyjskiej inwazji na Ukrainę,2022-03-01,7993,453,96038,1379.0,No sponsor,8968146,202
203. Polska wobec rosyjskiej inwazji na Ukrainę,2022-03-06,9429,805,126794,1868.0,No sponsor,9094940,203
204. Jak Zachód izoluje Rosję,2022-03-11,5904,379,82320,938.0,No sponsor,9177260,204
205. Jak Rosja stała się państwem totalitarnym,2022-03-17,4809,347,58711,788.0,No sponsor,9235971,205
206. Jak Władimir Putin został prezydentem?,2022-03-24,2995,136,43871,919.0,No sponsor,9279842,206
207. Joe Biden w Polsce (i nie tylko),2022-03-29,3114,121,38079,700.0,No sponsor,9317921,207
208. Wojna na Ukrainie - Uniwersytet Ekonomiczny w Krakowie,2022-04-01,3155,271,48429,5959.0,No sponsor,9366350,208
209. Polska i Węgry – koniec politycznej przyjaźni?,2022-04-06,3693,388,59090,611.0,No sponsor,9425440,209
210. Ukraina - kluczowy moment wojny?,2022-04-08,4951,305,70367,680.0,No sponsor,9495807,210
211. Podsumowanie wydarzeń ze świata,2022-04-14,3901,248,51304,861.0,No sponsor,9547111,211
212. Czy Stany Zjednoczone tracą wpływ na Półwysep Arabski?,2022-04-21,3199,183,45980,689.0,No sponsor,9593091,212
213. Ukraina w Unii Europejskiej? - wykład Szkoła Główna Handlowa,2022-04-28,504,66,12960,6221.0,No sponsor,9606051,213
214. Ukraina – religijny wymiar starcia cywilizacji,2022-05-04,3477,307,50375,747.0,No sponsor,9656426,214
215. Podsumowanie wydarzeń ze świata - Maj 2022 #1,2022-05-06,4256,240,56312,574.0,No sponsor,9712738,215
216. Czechy – nowoczesny konserwatyzm,2022-05-11,3939,470,43256,800.0,No sponsor,9755994,216
217. Podsumowanie wydarzeń ze świata - Maj 2022 #2,2022-05-13,3810,198,47125,622.0,No sponsor,9803119,217
"218. LIVE Q&A - Marcin Kuśmierczyk, Polityka Zagraniczna",2022-05-16,937,48,15989,4410.0,No sponsor,9819108,218
219. Dlaczego Polska nadal nie dostała środków z Unii Europejskiej?,2022-05-18,2336,276,37121,1033.0,No sponsor,9856229,219
220. Podsumowanie wydarzeń ze świata - Maj 2022 #3,2022-05-20,3071,169,47282,617.0,No sponsor,9903511,220
221. Nowy układ sił w Europie?,2022-05-25,7007,728,163159,1103.0,No sponsor,10066670,221
222. Podsumowanie wydarzeń ze świata - Maj 2022 #4,2022-05-27,2883,134,42491,709.0,No sponsor,10109161,222
223. Kryzys żywnościowy – komu i dlaczego grozi głód?,2022-06-01,3053,328,46735,748.0,No sponsor,10155896,223
224. Nowe warunki w Krajowym Planie Odbudowy i konsultacje rządów Polski i Ukrainy,2022-06-03,2736,199,34493,625.0,No sponsor,10190389,224
225. Polski plan odbudowy – wizja przyszłości czy niebezpieczna utopia?,2022-06-09,2806,275,51445,872.0,No sponsor,10241834,225
226. Kto rządzi w Europie?,2022-06-15,3270,286,50673,1024.0,No sponsor,10292507,226
227. Niemiecki plan reformy UE i słabnąca pozycja prezydenta Francji,2022-06-23,3177,136,49233,903.0,No sponsor,10341740,227
228. Zachodnia odpowiedź na Nowy Jedwabny Szlak,2022-06-29,2885,223,62561,735.0,No sponsor,10404301,228
229. Nowa koncepcja strategiczna NATO  – rezultaty szczytu z Madrytu,2022-07-01,3223,215,49553,843.0,No sponsor,10453854,229
230. USA – podzielone imperium,2022-07-06,3375,260,49104,724.0,XTB,10502958,230
"231. Rezygnacja Borisa Johnsona, niemiecka presja na Litwę i morderstwo Shinzo Abe",2022-07-08,3331,214,51556,625.0,XTB,10554514,231
232. Kryzys energetyczny w Europie,2022-07-21,3083,224,45011,1003.0,XTB,10599525,232
233. Bliskowschodnia rozgrywka,2022-07-27,2396,79,37317,738.0,XTB,10636842,233
234. Upadek rządu we Włoszech,2022-07-29,2847,160,46252,623.0,XTB,10683094,234
235. Tajwan – czyli mocarstwowa gra w tchórza,2022-08-03,3658,198,63074,780.0,XTB,10746168,235
236. Radykalny spadek wpływów politycznych Niemiec w Europie,2022-08-10,5481,440,89462,814.0,XTB,10835630,236
237. Białoruś – represje i walka o wolność,2022-08-12,3712,216,46560,567.0,XTB,10882190,237
238. Ukraińska tożsamość  – czyli kluczowy czynnik dla przebiegu wojny,2022-08-18,3440,341,51225,778.0,XTB,10933415,238
239. Systemowa bezradność wobec wojny,2022-08-24,2866,185,48462,713.0,XTB,10981877,239
240. Zachód kulturowym zagrożeniem dla Polski?,2022-08-31,4075,579,46116,864.0,XTB,11027993,240
241. Zachód politycznym zagrożeniem dla Polski?,2022-09-02,2745,341,37849,807.0,XTB,11065842,241
242. Ukraińska ofensywa  – polityczne konsekwencje,2022-09-13,3848,163,51144,680.0,XTB,11116986,242
243. Reparacje i raport o stratach wojennych,2022-09-16,3086,237,38069,763.0,No sponsor,11155055,243
244. Nowe gwarancje bezpieczeństwa dla Ukrainy – Kyiv Security Compact,2022-09-20,2665,170,42113,704.0,XTB,11197168,244
"245. Mobilizacja, referenda i Zgromadzenie Ogólne ONZ",2022-09-22,4058,228,52230,764.0,XTB,11249398,245
246. Węgierska tożsamość narodowa,2022-09-27,2496,124,42050,1981.0,No sponsor,11291448,246
247. Zniszczenie gazociągów Nord Stream – nie będzie powrotu do przeszłości,2022-09-29,5200,497,93863,683.0,XTB,11385311,247
248. Masowe protesty w Iranie,2022-10-05,3273,231,41600,654.0,XTB,11426911,248
249. Brutalna walka o gospodarczą przyszłość Europy,2022-10-07,4305,314,71940,748.0,No sponsor,11498851,249
250. Indie – stosunek do Rosji i rola w systemie międzynarodowym,2022-10-12,3579,336,45121,732.0,XTB,11543972,250
251. Nowa strategia bezpieczeństwa USA – epoka rywalizacji mocarstw,2022-10-14,3924,231,64452,972.0,No sponsor,11608424,251
"252. Chiny – przemówienie Xi Jinpinga - modernizacja, Tajwan i wizja przyszłości",2022-10-20,3246,145,55723,843.0,XTB,11664147,252
253. Krótko o odbudowie Ukrainy i dwa zaproszenia,2022-10-25,1895,127,28770,311.0,XTB,11692917,253
254. Francja i Niemcy – traktat łączący dwie największe gospodarki UE,2022-11-02,2590,89,43406,743.0,XTB,11736323,254
255. Imperialna prezydentura i wybory do Kongresu USA,2022-11-08,2414,132,38177,810.0,XTB,11774500,255
256. Republikanie – czy Donald Trump zdominuje partię?,2022-11-10,2301,117,34519,1138.0,XTB,11809019,256
257. Jak Rosja chce odwrócić losy wojny?,2022-11-16,3893,273,56596,796.0,XTB,11865615,257
258. Co prezes PiS mówi o Niemczech?,2022-11-24,2813,1122,47279,1165.0,XTB,11912894,258
259. Perspektywy współpracy Polski i Ukrainy,2022-11-27,1113,263,31449,5299.0,XTB,11944343,259
260. Czy w 2023 roku czeka nas kryzys gospodarczy?,2022-11-30,2240,112,42478,850.0,XTB,11986821,260
261. Strategiczne różnice między wschodem a zachodem Europy,2022-12-06,3139,254,50686,1281.0,XTB,12037507,261
262. Czy możliwa jest wojna handlowa między USA i UE?,2022-12-08,2324,128,40025,775.0,XTB,12077532,262
263. Ukraińska wojna informacyjna – Wydział Bezpieczeństwa Narodowego Akademii Sztuki Wojennej,2022-12-14,889,76,15523,2019.0,No sponsor,12093055,263
264. Chiny i Arabia Saudyjska - strategiczne partnerstwo? Wizyta Xi Jinpinga na Półwyspie Arabskim,2022-12-16,1890,72,30134,976.0,XTB,12123189,264
"265. Chaos w sprawie unijnych pieniędzy, czyli kolejna próba odblokowania KPO",2022-12-21,2037,232,32862,1095.0,XTB,12156051,265
266. Prezydent Zełenski w USA oraz kolejny wspólny dług UE,2022-12-23,3047,153,31908,817.0,XTB,12187959,266
267. Dlaczego Rosja musi przegrać?,2023-01-05,4944,664,75915,975.0,XTB,12263874,267
268. Znaczenie Ukrainy dla bezpieczeństwa Polski 500 lat temu,2023-01-11,3669,322,42245,980.0,XTB,12306119,268
269. Białoruś  – wróg reżimu Aleksandra Łukaszenki,2023-01-18,2710,207,37194,842.0,XTB,12343313,269
270. Porażka rosyjskiego szantażu energetycznego,2023-01-20,3551,304,58607,768.0,XTB,12401920,270
271. Kto wygra wybory w Czechach?,2023-01-23,1575,125,24508,1777.0,XTB,12426428,271
272. Między Rosją a Niemcami – czyli o relacjach Berlina z Moskwą,2023-01-26,4619,442,62308,1506.0,XTB,12488736,272
273. Czy grozi nam rozpad europejskiego rynku?,2023-02-01,2577,145,40169,992.0,XTB,12528905,273
274. Dramatyczny kryzys polityczny i gospodarczy w Libanie,2023-02-03,1632,133,21340,1103.0,XTB,12550245,274
275. Wielka Brytania czy mała Anglia? Londyn w świecie przyszłości,2023-02-08,2884,379,56228,1002.0,XTB,12606473,275
276. Ukraiński prezydent w stolicach Europy,2023-02-10,2583,202,34864,765.0,XTB,12641337,276
277. Historyczna szansa dla Polski,2023-02-16,5775,690,97959,1148.0,XTB,12739296,277
278. Joe Biden w Kijowie i stosunek Ukraińców do Białorusi - Iullia Mendel,2023-02-20,1826,123,29063,891.0,XTB,12768359,278
279. Polityczne skutki rosyjskiej inwazji na Ukrainę,2023-02-24,1064,98,25440,4036.0,XTB,12793799,279
280. Stan gry o przyszłość świata,2023-03-01,4167,208,71913,1427.0,XTB,12865712,280
281. Rosja traci wpływy w Azji Centralnej,2023-03-03,1705,80,36318,1493.0,XTB,12902030,281
282. USA vs Chiny – retoryczna eskalacja,2023-03-08,2775,269,46946,929.0,XTB,12948976,282
283. Q&A: Czy wrócą lata świetności Europy? Rozpad Rosji?,2023-03-14,2449,258,48055,1782.0,XTB,12997031,283
284. Czy Azja zdecyduje o wyniku wojny?,2023-03-19,2587,200,50963,924.0,XTB,13047994,284
285. Francja – systemowe powody wielkich protestów,2023-04-06,3389,229,43177,879.0,XTB,13091171,285
286. Strategiczny rozłam w Europie,2023-04-13,3771,385,72397,1205.0,XTB,13163568,286
287. Nowa polityka zagraniczna Polski,2023-04-18,3792,477,63810,1065.0,XTB,13227378,287
288. Stan polityki międzynarodowej – Uniwersytet Ekonomiczny w Krakowie,2023-04-22,556,47,12037,5262.0,No sponsor,13239415,288
289. Czy Polska zostanie pośrednikiem w handlu międzynarodowym dla Ukrainy?,2023-04-27,2234,269,40616,962.0,XTB,13280031,289
290. Między wielkim zagrożeniem a wielką szansą – Europa Środkowo-Wschodnia po rosyjskiej agresji,2023-05-03,539,44,14939,6048.0,No sponsor,13294970,290
291. Co jeśli trwały pokój jest niemożliwy?,2023-05-05,2762,276,50514,1152.0,XTB,13345484,291
292. Olaf Scholz w PE: Federalizacja w zamian za rozszerzenie Unii Europejskiej?,2023-05-11,2996,556,55965,966.0,XTB,13401449,292
293. FitFor55 czyli obraz europejskiej transformacji energetycznej,2023-05-16,1891,561,30231,1137.0,XTB,13431680,293
294. Co po Łukaszence?,2023-05-19,2453,132,49260,869.0,XTB,13480940,294
295. Dlaczego Polska wspiera Ukrainę?,2023-05-24,3228,742,54028,1173.0,XTB,13534968,295
296. Nie będzie bankructwa USA — rozmowa z inwestorem,2023-05-30,549,24,12992,2064.0,XTB,13547960,296
297. Komisja ds. badania rosyjskich wpływów czyli polityka zagraniczna w służbie kampanii wyborczej,2023-06-01,3510,517,40312,1077.0,XTB,13588272,297
298. Potężna skala klęski strategicznej Władimira Putina,2023-06-08,5670,989,145132,867.0,XTB,13733404,298
299. WYKŁAD - Polityczna przyszłość Europy,2023-06-12,883,93,21633,3638.0,No sponsor,13755037,299
300. Europejski pakt migracyjny. Obowiązkowa relokacja albo kary finansowe?,2023-06-15,2394,473,42324,1122.0,XTB,13797361,300
301. Ukraińskie gwarancje bezpieczeństwa – stan gry,2023-06-20,1937,189,40045,968.0,XTB,13837406,301
302. Bunt Prigożyna wyzwaniem dla systemu władzy w Rosji,2023-06-28,3076,168,47530,1008.0,XTB,13884936,302
"303. USA, Indie, Chiny – rozgrywka mocarstw",2023-06-30,1918,61,32629,788.0,XTB,13917565,303
304. Prezydent chce prowadzić politykę europejską Polski  – projekt ustawy,2023-07-04,1623,193,33583,956.0,XTB,13951148,304
305. Co Niemcy i Ukraińcy sądzą o Polsce?,2023-07-08,4906,774,142039,782.0,XTB,14093187,305
306. Ukraińskie rozczarowanie i nowe plany obronne - szczyt NATO w Wilnie,2023-07-13,2463,271,51741,1144.0,XTB,14144928,306
307. Upadek rządu w Holandii,2023-07-18,4150,554,132764,849.0,No sponsor,14277692,307
308. Korea Południowa strategicznym partnerem Polski?,2023-07-26,3448,493,55268,1016.0,XTB,14332960,308
309. Niemcy – wzrost skrajnej prawicy a rewizjonizm historyczny,2023-07-29,4331,1214,90400,732.0,XTB,14423360,309
310. Hiszpania po wyborach parlamentarnych,2023-08-03,2341,155,42114,793.0,XTB,14465474,310
311. Trump oskarżony o spisek przeciwko Stanom Zjednoczonym,2023-08-10,2460,288,45747,1147.0,XTB,14511221,311
"312. Dwa nierealne scenariusze czyli ,,izraelski” i ,,koreański” model dla Ukrainy",2023-08-16,2531,285,50380,971.0,XTB,14561601,312
313. BRICS – nowa siła polityczna czy nieistotna grupa dyskusyjna?,2023-08-24,2831,314,54369,1226.0,XTB,14615970,313
314. Publicystyka Adama Mickiewicza – źródła polskiego spojrzenia na świat,2023-08-30,2029,101,30776,984.0,XTB,14646746,314
315. Reforma i rozszerzenie Unii Europejskiej do 2030 roku?,2023-09-02,2493,374,45406,797.0,XTB,14692152,315
316. Co czeka Rosję?,2023-09-06,3452,347,67646,1186.0,XTB,14759798,316
317. Jakie treści na temat Polski powstają za granicą i jak to wykorzystać?,2023-09-13,4813,731,89131,894.0,XTB,14848929,317
318. Inicjatywa G20 szansą dla Trójmorza?,2023-09-18,2082,123,36973,802.0,XTB,14885902,318
319. Porażka europejskiej polityki w kwestii migracji,2023-09-21,3015,414,54839,938.0,XTB,14940741,319
320. Spór Polski i Ukrainy – strategiczne wnioski,2023-09-29,3838,655,93609,1140.0,XTB,15034350,320
321. Europejski krok w stronę wojny handlowej z Chinami,2023-10-06,2087,128,37029,966.0,XTB,15071379,321
322. Izrael i Hamas – podstawowe fakty i krótka opinia,2023-10-12,8637,1076,238029,1206.0,XTB,15309408,322
323. Przyszłość polityki europejskiej Polski,2023-10-25,3515,631,66861,996.0,XTB,15376269,323
324. Strategiczna postawa Stanów Zjednoczonych,2023-10-28,2777,244,50850,956.0,XTB,15427119,324
325. Czy dojdzie do federalizacji Unii Europejskiej?,2023-11-03,3126,654,56459,1311.0,XTB,15483578,325
326. Dlaczego Rosja dąży do zniszczenia Polski?,2023-11-09,13633,4587,411217,1318.0,XTB,15894795,326
327. Zachodnia fatyga wojenna,2023-11-18,2608,547,51165,863.0,XTB,15945960,327
328. Chiny i USA – rozmowy o przyszłości świata,2023-11-22,2341,120,37737,987.0,XTB,15983697,328
329. Reforma konstytucyjna we Włoszech?,2023-11-28,1998,96,29093,688.0,XTB,16012790,329
330. Przyczyny protestu na granicy – czyli nowy rodzaj wyzwania dla gospodarki Polski,2023-12-01,2068,278,32724,1081.0,XTB,16045514,330
331. COP28 w Dubaju czyli klimatyczny szczyt absurdu,2023-12-08,2284,255,36949,843.0,XTB,16082463,331
332. Prawdziwa stawka agresji Rosji na Ukrainę  – czyli dziejowe znaczenie wojny na wschodzie,2023-12-15,7413,997,249451,1478.0,XTB,16331914,332
"333. Szczyt Unia – Chiny, czyli europejskie ultimatum",2023-12-22,3092,225,74162,863.0,XTB,16406076,333
334. Rosja jako mocarstwo kolonialne i rola woli w procesie politycznym,2024-01-09,2550,280,42928,1157.0,XTB,16449004,334
335. Niemieckie protesty i nadchodzący europejski kryzys,2024-01-12,2732,323,49501,980.0,XTB,16498505,335
336. Fundament systemu międzynarodowego,2024-01-18,1884,93,28668,914.0,XTB,16527173,336
337. Źródła biedy i bogactwa. Teoria systemów-światów,2024-01-24,2152,158,31613,1030.0,XTB,16558786,337
338. Nieuchronny koniec jednobiegunowego świata,2024-01-27,3422,392,70878,965.0,XTB,16629664,338
339. Dołącz do Polityki Zagranicznej!,2024-01-29,1129,86,11660,520.0,No sponsor,16641324,339
340. Czy migracja zdecyduje o wyniku wyborów w Stanach Zjednoczonych?,2024-02-01,3237,209,34865,1221.0,XTB,16676189,340
341. Złamanie Węgier a przyszłość Unii Europejskiej,2024-02-07,3075,430,49984,1218.0,XTB,16726173,341
342. Czym są Niemcy dla Polski? [Pytanie do Ground Zero],2024-02-09,2525,292,38177,651.0,XTB,16764350,342
343. Jak zmienić optykę na Unię Europejską?,2024-02-14,2530,387,35422,1048.0,XTB,16799772,343
344. Europejski zwrot – polityka zagraniczna nowego rządu Polski,2024-02-16,2923,405,45940,1042.0,XTB,16845712,344
345. Nowy etap relacji Polski z USA,2024-02-22,2567,200,39611,961.0,XTB,16885323,345
346. Odblokowanie pieniędzy dla Polski czyli niesmaczny koniec koszmarnej historii,2024-02-28,3147,462,46862,1419.0,XTB,16932185,346
"347. Wojska NATO na Ukrainie — europejska gra o status, a bezpieczeństwo Polski",2024-03-01,2422,239,42518,1084.0,XTB,16974703,347
348. Systemowe przyczyny starszej klasy politycznej w USA,2024-03-06,2290,209,35482,1138.0,XTB,17010185,348
349. Rola Polski w Europie – czyli jak komunikować nowy poziom ambicji politycznych,2024-03-09,3196,334,36407,1070.0,XTB,17046592,349
350. Jak zmienia się priorytet Polski w polityce regionalnej?,2024-03-14,2821,242,37748,1272.0,XTB,17084340,350
351. USA vs Chiny – strategiczne obawy Stanów Zjednoczonych,2024-03-21,2236,247,39902,1072.0,XTB,17124242,351
352. Groźba wojny a potrzeba modernizacji Polski,2024-03-27,2874,235,46538,1163.0,XTB,17170780,352
353. Dlaczego Izrael przegrywa wojnę?,2024-04-05,3261,596,55054,1108.0,XTB,17225834,353
354. Rosyjscy szpiedzy a bezpieczeństwo Europy,2024-04-10,1892,139,28694,834.0,XTB,17254528,354
"355. Porażka Rosji. Scenariusz, którego obawia się Zachód?",2024-04-14,2707,323,53418,1374.0,XTB,17307946,355
356. Czy Rosja przestała być egzystencjalnym zagrożeniem dla Zachodu?,2024-04-16,231,16,6339,58.0,No sponsor,17314285,356
357. Rosyjska siatka szpiegowska w centrum Europy,2024-04-18,202,11,4885,52.0,No sponsor,17319170,357
358. Czy Polska zatrzyma pakt migracyjny?,2024-04-18,2229,0,36136,1539.0,XTB,17355306,358
"359. Jak Rosjanie uzyskali dostęp do danych z telefonów, które wpadły do Dunaju?",2024-04-21,150,4,5161,35.0,No sponsor,17360467,359
360. Czy Rosja może odnieść zwycięstwo w starciu z Europą?,2024-04-23,204,17,4889,59.0,No sponsor,17365356,360
361. Jak pokonać Rosję?,2024-04-24,2334,129,31119,1073.0,XTB,17396475,361
362. Dlaczego wprowadzenie paktu migracyjnego to klęska Polski?,2024-04-25,417,8,8690,46.0,No sponsor,17405165,362
363. Co ULTIMATUM Rosji oznacza dla Polski?,2024-04-28,5667,740,68799,924.0,XTB,17473964,363
364. Co Polska może zaoferować wschodnim sąsiadom?,2024-04-30,143,5,3984,36.0,No sponsor,17477948,364
365. Czy Polska jest w pełni niezależna?,2024-05-02,161,16,7429,43.0,No sponsor,17485377,365
366. Polska polityka zagraniczna oczami Radosława Sikorskiego,2024-05-02,1928,271,30252,948.0,XTB,17515629,366
367. Czego chce Rosja?,2024-05-05,193,34,9950,32.0,No sponsor,17525579,367
368. Polska polityka zagraniczna a sprawa ukraińska,2024-05-07,85,5,4235,58.0,No sponsor,17529814,368
369. Emmanuel Macron i jego wizja przyszłości Europy,2024-05-07,2244,319,35890,1104.0,XTB,17565704,369
370. Jak sytuacja w Strefie Gazy wpływa na wiarygodność Zachodu w oczach Globalnego Południa?,2024-05-09,193,13,3932,60.0,No sponsor,17569636,370
371. CHIŃSKIE samochody ZALEJĄ Europę?,2024-05-12,1769,330,30911,1131.0,XTB,17600547,371
372. Kluczowy zasób Polski,2024-05-12,150,12,3103,57.0,No sponsor,17603650,372
373. Europa jest w ŚMIERTELNYM zagrożeniu,2024-05-14,205,20,7018,31.0,No sponsor,17610668,373
374. Polska sojusznikiem drugiej kategorii? Akt NATO-ROSJA z 1997 roku,2024-05-15,1821,209,34294,1021.0,XTB,17644962,374
375. Ursula von der Leyen: Nie pozwolę na zalanie Europy chińskimi elektrykami!,2024-05-17,125,10,4262,22.0,No sponsor,17649224,375
376. Porażka Polski ws. paktu migracyjnego i dalszy ciąg wojny handlowej,2024-05-19,1835,249,29147,1049.0,XTB,17678371,376
377. PRL jako wzór stosunków polsko-rosyjskich. Czy tego chce Rosja?,2024-05-21,333,26,9071,42.0,No sponsor,17687442,377
378. Dokąd zmierza Europa? Wykład dla SKN Spraw Zagranicznych SGH,2024-05-22,561,85,11895,7059.0,No sponsor,17699337,378
379. Czy zależność od sprzedaży ropy to słabość Rosji? Q&A dla Patronów,2024-05-23,1050,63,15099,762.0,XTB,17714436,379
380. MACRON: Zmiana modelu społecznego w Europie jest NIEUNIKNIONA!,2024-05-25,203,25,4344,42.0,No sponsor,17718780,380
381. Czy głosować na Konfederację? Wybory do Europarlamentu #1,2024-05-27,1436,538,25549,1684.0,XTB,17744329,381
382. Czy głosować na Koalicję Obywatelską? Wybory do Europarlamentu #2,2024-05-28,377,168,7290,2025.0,XTB,17751619,382
383. Czy głosować na Trzecią Drogę? Wybory do Europarlamentu #3,2024-05-29,314,119,5472,1303.0,XTB,17757091,383
384. Czy głosować na Lewicę? Wybory do Europarlamentu #4,2024-05-30,410,203,7401,2437.0,XTB,17764492,384
385. Czy głosować na Prawo i Sprawiedliwość? Wybory do Europarlamentu #5,2024-05-31,289,97,5537,1800.0,XTB,17770029,385
386. Anna Bryłka [KONFEDERACJA]: Europa nie jest w stanie konkurować z Chinami,2024-06-02,329,23,9552,44.0,No sponsor,17779581,386
387. Marcin Bosacki [KOALICJA OBYWATELSKA]: Zakaz samochodów spalinowych się nie uda!,2024-06-03,78,12,4958,34.0,No sponsor,17784539,387
388. Michał Gramatyka: Nie jestem zwolennikiem europejskiego długu,2024-06-04,26,8,1723,38.0,No sponsor,17786262,388
"389. Pakt Chiny-Rosja: wojna w Ukrainie, europejska gospodarka i starcie z USA",2024-06-04,1457,142,27420,1308.0,XTB,17813682,389
390. Paulina Matysiak [LEWICA]: Korporacje zrzucają ciężar zmian klimatu na jednostki!,2024-06-06,52,7,1876,57.0,No sponsor,17815558,390
391. Michał Dworczyk o celach PiSu w Unii Europejskiej,2024-06-07,36,12,2124,47.0,No sponsor,17817682,391
392. Prawdziwa stawka wyborów do Europarlamentu,2024-06-07,1620,146,26502,1190.0,XTB,17844184,392
393. Unia Europejska: Monolit czy mozaika państw o różnych interesach?,2024-06-10,279,17,8911,39.0,No sponsor,17853095,393
394. Jaka będzie przyszłość Indii? Zaskakujący wynik największych wyborów w historii świata,2024-06-11,1515,91,21337,885.0,XTB,17874432,394
395. Rosja: Nasz namiestnik albo wojna!,2024-06-13,173,20,8751,27.0,No sponsor,17883183,395
"396. Dbajmy o polskie instytucje, jeśli chcemy zbudować silne i bezpieczne państwo!",2024-06-15,198,45,4763,50.0,No sponsor,17887946,396
397. Dyrektywa budynkowa UE. Przejaw ideologii czy szansa dla milionów Polaków?,2024-06-17,1230,279,20571,1136.0,XTB,17908517,397
398. Dyplomatyczna gra o przyszłość Ukrainy,2024-06-20,1541,129,24834,846.0,XTB,17933351,398
399. Andrzej Duda w Pekinie. Rezultaty wizyty Prezydenta w Chinach,2024-06-27,2000,200,27863,1249.0,XTB,17961214,399
"400. Zarobki na YouTube, broń atomowa w Polsce i wizja polityki wschodniej. Q&A dla Patronów",2024-07-01,745,44,11132,1222.0,XTB,17972346,400
401. Trump v Biden. Walka o przyszłość Ameryki,2024-07-04,1930,104,30761,1004.0,XTB,18003107,401
402. Za zamkniętymi drzwiami. Dokąd zaprowadzi nas strategia nowego przywództwa UE?,2024-07-08,1858,142,31797,1292.0,XTB,18034904,402
403. Koniec epoki Konserwatystów. Polityczne trzęsienie ziemi w UK!,2024-07-11,1531,71,22190,874.0,XTB,18057094,403
404. Wielki kryzys polityczny. Co stało się we Francji?,2024-07-17,1360,100,21206,850.0,XTB,18078300,404
405. Szczyt NATO: amerykańskie rakiety w Europie i wsparcie dla Ukrainy,2024-07-22,1150,50,19496,896.0,XTB,18097796,405
406. Polsko-Niemiecki Plan Działania – czyli nowy rozdział i stare problemy,2024-07-25,1595,177,24582,906.0,XTB,18122378,406
